majorrivers = {
    #Guadalquivir (Hispania)
    224 225 1748

    #Douro (Hispania)
    207 208 4553 215 4789 2755 232 216 228 231

    #Tagus (Hispania)
    227 4551 4788 219 217

    #Ebro (Hispania)
    2988 214 4557 210 2989 209

    #Garonne (France)
    174 175 196 4694

    #Rhône (France)
    193 192 1877 203 204 202 201

    #Loire (France)
    199 190 191 179 184 4776 4389 177 178 172

    #Seine (France)
    4392 4390 185 186 183 4388 167

    #Rhine (Low Countries, Germany)
    4712 72 1869 1870 74 4714 77 78 1760 85 84 2975 99 98 4383 96

    #Elbe (Germany)
    1771 61 59 58 52 2964 4786 53 1857 44

    #Oder (Poland)
    263 4723 264 2966 2969 49 50 2993 1858 4746

    #Vistula (Poland)
    262 259 2959 260 257 1938 4525 256 4524 4528 4523 1859 2997 43 1841

    #Dnieper (Ukraine)
    4245 293 4246 771 292 4115 4544 280 2407 1944 4542 290 2411 283 2406 1974

    #Don (Ukraine)
    4255 2408 299 467 1971 288 2413 2414 286

    #Volga (Russia)
    1752 4249 294 4248 4147 4250 308 1753 1957 306 2422 1082 4264 4267 1081 473 2419 2418 303 466 464

    #Danube (Germany, Carpathia, Balkans)
    4713 1872 4711 2955 2957 2956 4709 133 1770 4762 134 1772 153 1864 4126 4173 1954 156 4239 141 4176 2746 4532 160 150 4704 4531 2998 159 4706 4530 1756

    #Po (Italy)
    1875 2981 103 2979 4728 104 1862 105 109 113

    #Tiber (Italy)
    2976 4731 118

    #Nile (Egypt, Nubia)
    1217 1216 2799 2800 1222 2798 1220 2797 1229 1228 2322 1234 1231 4319 360 4320 2319 2317 4318 359 361 2316 362 363 4316

    #Senegal (West Africa)
    2248 1120 2245 2244 2240 1115 2237 1113

    #Volta (West Africa)
    1137 2267 2254 1136 2256 2295 1140 1138 1141

    #Niger (West Africa)
    1121 1124 2249 2250 1123 1131 1134 2261 2259 2260 1132 2262 1133 2268 1142 2270 2278 1143 2293 1145 1144 1146 1153 2289 1152 2294 1147

    #Congo (Congo)
    4081 1169 1901 4079

    #Zambezi (East Africa)
    1189 1190 1191 1187 1192

    #Tigris & Euphrates (Mesopotamia)
    418 4295 4293 411 4294 415 2310 410 4291 2312 4288 408 2311 409 406 2314 407 2308 377 4298 2303 4310 329 2305 331

    #Indus (Western India)
    509 4449 2075 507 2076 4511 4510 4513 4508 506 4509 2078 2086 2079 2072 4505 505 4503 504 4504

    #Ganges (Eastern India)
    4493 511 2062 2060 2061 4498 522 524 4500 4465 525 2059 2063 4499 4497 523 559 4496 556 2095 555 4490 4495 4494 4492 554 2094 2055 4487 4488 4491 4485 4468 2097 2098 4469 558 4489 4472 2047 4486 4483 2071 2044 563 2096 4479 2081 4476 4475 4477 561 2039

    #Brahmaputra (Eastern India)
    2040 566 571 2042 562 4482 565 2045 2046 564 4474

    #Irrawaddy (Burma)
    2395 2396 582 4405 4393 581 584 2398 2397 4404 2399 4394 4396 586 4399 1815

    #Chao Phraya (Indochina)
    1817 2388 4833 2389 601 4841 4834 4832 600 4831

    #Mekong (Indochina)
    705 2131 2132 2167 661 2165 660 587 2381 602 615 614 2384 611 2382 4838 4840 4839 1823 4828 4827 2378 2380 604 4826 2376

    #Yangtze (China)
    2133 678 2748 4213 4212 679 2170 680 681 2172 672 671 682 4197 683 686 1838 1821 2145 685 1822

    #Huang He (China)
    699 2180 4198 700 2179 694 1836 692 688 2176 2141 4196 2142
}

oyaman = {
    1163 1151 2294 1147 2289 1152 1162 1249 1161 2281 1153 1154 1145 2293 1146 1144 2290
}